$                              $
$                              $
$                              $
$                              $
$                              $
$                              $
$                              $
$                              $
$                              $
$                              $
$                              $
$                              $
$                              $
$                              $
$                              $
$                              $
$                              $
$                              $
$                              $
$                              $
$                              $
$                              $
$                              $
$                              $
$                              $
$                              $
$                              $
$                              $
$                              $
$             A                $
$$$$$$$$$$$$$$$$$$$$$$$$$$$$$$$$